##########################
#                        #
#      #          #      #
#    #   #      #   #    #
#   #      #  #      #   #
#  #        #         #  #
#   #                #   #
#    #              #    #
#     #      @     #     #
#      #          #      #
#       #        #       #
#        #     #         #
#         #   #          #
#          # #           #
#           #            #
##########################