##################################################
#  #               ##                            #
#  #                ##                           #
#  #  #              ##                          #
#  #                  ##                         #
#     #                ##                        #
#  #  #                  ##                      #
#                          #                     #
#  #                 @       ##                  #
#     #                        ##                #
#  #  #                          ##              #
#                                  ##            #
#  #  #                              ##          #
#     #                                #         #
#  #  #                                 #  #######
#     #                                 #        #
#  #  #                                 ######## #
#     #                                 #        #
##################################################