%%%%%%%%%%%%%%%%%%%%
%                  %
%                  %
%                  %
%        @         %
%                  %
%                  %
%                  %
%%%%%%%%%%%%%%%%%%%%